.;.;.;.;.;.;.;.;.;.;.;.;.;.;.;.;.;.;.;.;B;B;B;B;B;B;B;B;B;B;B;.;.;.;.;.;.;.;.;.;.;.;.;.;.;.;.;.;.;.;.;.;.;.;.;.;.;.;.;.;.;.;.;.;.;.;.;.;.;.;.;.;.;.;.;.;.;.;.;.;.;.;.;.;.;.;.;.;.;.;.;.;.;.;.;.;.;.;.;.
.;.;.;.;.;.;.;.;.;.;.;.;.;.;.;.;.;.;.;.;B;.;.;.;.;.;.;.;.;.;B;.;.;.;.;.;.;.;.;.;.;.;.;.;.;.;.;.;.;.;.;.;.;.;.;.;.;.;.;.;.;.;.;.;.;.;.;.;.;.;.;.;.;.;.;.;.;.;.;.;.;.;.;.;.;.;.;.;.;.;.;.;.;.;.;.;.;.;.;.
.;.;.;.;.;.;.;.;.;.;.;.;.;.;.;.;.;.;.;.;B;.;.;.;.;.;.;.;.;.;B;.;.;.;.;.;.;.;.;.;.;.;.;.;.;.;.;.;.;.;.;.;.;.;.;.;.;.;.;.;.;.;.;.;.;.;.;.;.;.;.;.;.;.;.;.;.;.;.;.;.;.;.;.;.;.;.;.;.;.;.;.;.;.;.;.;.;.;.;.
.;.;.;.;.;.;.;.;.;.;.;.;.;.;.;.;.;.;.;.;B;.;.;.;.;.;.;.;.;.;B;.;.;.;.;.;.;.;.;.;.;.;.;.;.;.;.;.;.;.;.;.;.;.;.;.;.;.;.;.;.;.;.;.;.;.;.;.;.;.;.;.;.;.;.;.;.;.;.;.;.;.;.;.;.;.;.;.;.;.;.;.;.;.;.;.;.;.;.;.
.;.;.;.;.;.;.;.;.;.;.;.;.;.;.;.;.;.;.;.;B;.;.;.;.;.;.;.;.;.;B;.;.;.;.;.;.;.;.;.;.;.;.;.;.;.;.;.;.;.;.;.;.;.;.;.;.;.;.;.;.;.;.;.;.;.;.;.;.;.;.;.;.;.;.;.;.;.;.;.;.;.;.;.;.;.;.;.;.;.;.;.;.;.;.;.;.;.;.;.
.;.;.;.;.;.;.;.;.;.;.;.;.;.;.;.;.;.;.;.;B;.;.;.;.;B;.;.;.;.;B;.;.;.;.;.;.;.;.;.;.;.;.;.;.;.;.;.;.;.;.;.;.;.;.;.;.;.;.;.;.;.;.;.;.;.;.;.;.;.;.;.;.;.;.;.;.;.;.;.;.;.;.;.;.;.;.;.;.;.;.;.;.;.;.;.;.;.;.;.
.;.;.;.;.;.;.;.;.;.;.;.;.;.;.;.;.;.;.;.;B;.;.;.;.;B;.;.;.;.;B;.;.;.;.;.;.;.;.;.;.;.;.;.;.;.;.;.;.;.;.;.;.;.;.;.;.;.;.;.;.;.;.;.;.;.;.;.;.;.;.;.;.;.;.;.;.;.;.;.;.;.;.;.;.;.;.;.;.;.;.;.;.;.;.;.;.;.;.;.
.;.;.;.;.;.;.;.;.;.;.;.;.;.;.;.;.;.;.;.;B;.;.;.;.;B;.;.;.;.;B;.;.;.;.;.;.;.;.;.;.;.;.;.;.;.;.;.;.;.;.;.;.;.;.;.;.;.;.;.;.;.;.;.;.;.;.;.;.;.;.;.;.;.;.;.;.;.;.;.;.;.;.;.;.;.;.;.;.;.;.;.;.;.;.;.;.;.;.;.
.;.;.;.;.;.;.;.;.;.;.;.;.;.;.;.;.;.;.;.;B;.;.;.;.;B;.;.;.;.;B;.;.;.;.;.;.;.;.;.;.;.;.;.;.;.;.;.;.;.;.;.;.;.;.;.;.;.;.;.;.;.;.;.;.;.;.;.;.;.;.;.;.;.;.;.;.;.;.;.;.;.;.;.;.;.;.;.;.;.;.;.;.;.;.;.;.;.;.;.
.;.;.;.;.;.;.;B;B;B;B;B;B;B;B;B;B;B;B;B;B;.;.;.;.;B;.;.;.;.;B;B;B;B;B;B;B;B;B;B;B;.;.;.;.;.;.;.;.;.;.;.;.;.;.;.;.;.;.;.;.;.;.;.;.;.;.;.;.;.;.;.;.;.;.;.;.;.;.;.;.;.;.;.;.;.;.;.;.;.;.;.;.;.;.;.;.;.;.;.
.;.;.;.;.;.;.;B;.;.;.;.;.;.;.;.;.;.;.;2;.;.;.;.;.;B;.;.;.;.;.;.;.;.;.;.;.;.;.;.;B;.;.;.;.;.;.;.;.;.;.;.;.;.;.;.;.;.;.;.;.;.;.;.;.;.;.;.;.;.;.;.;.;.;.;.;.;.;.;.;.;.;.;.;.;.;.;.;.;.;.;.;.;.;.;.;.;.;.;.
.;.;.;.;.;.;.;B;.;.;.;.;.;.;.;.;.;.;.;2;.;.;.;.;.;B;.;.;.;.;.;.;.;.;.;.;.;.;.;F<<^;B;B;B;B;B;B;B;B;B;B;B;B;B;B;B;B;.;.;.;.;.;.;.;.;.;.;.;.;.;.;.;.;.;.;.;.;.;.;.;.;.;.;.;.;.;.;.;.;.;.;.;.;.;.;.;.;.;.;.;.
.;.;.;.;.;.;.;B;.;.;.;.;.;.;.;.;.;.;.;2;.;.;F<;.;.;B;.;.;.;.;.;.;.;.;.;.;.;.;.;.;1;.;.;.;.;.;.;.;.;.;.;.;.;.;.;B;.;.;.;.;.;.;.;.;.;.;.;.;.;.;.;.;.;.;.;.;.;.;.;.;.;.;.;.;.;.;.;.;.;.;.;.;.;.;.;.;.;.;.;.
.;.;.;.;.;.;.;B;.;.;.;.;.;.;.;.;.;.;.;2;.;.;.;.;.;B;.;.;.;.;.;.;.;.;.;.;.;.;.;.;1;.;.;.;.;.;.;.;.;.;.;.;.;.;.;B;.;.;.;.;.;.;.;.;.;.;.;.;.;.;.;.;.;.;.;.;.;.;.;.;.;.;.;.;.;.;.;.;.;.;.;.;.;.;.;.;.;.;.;.
.;.;.;.;.;.;.;B;.;.;.;.;B;B;B;B;B;B;B;B;B;.;.;.;.;B;B;B;B;B;B;B;B;B;B;C>;.;.;.;.;1;.;.;.;.;.;.;.;.;.;.;.;.;.;.;B;.;.;.;.;.;.;.;.;.;.;.;.;.;.;.;.;.;.;.;.;.;.;.;.;.;.;.;.;.;.;.;.;.;.;.;.;.;.;.;.;.;.;.;.
.;.;.;.;.;.;.;B;.;.;.;.;B;.;.;.;.;.;.;.;B;.;.;.;.;B;.;.;.;.;.;.;.;.;.;.;.;.;.;.;1;.;.;.;.;.;.;.;.;.;.;.;.;.;.;B;.;.;.;.;.;.;.;.;.;.;.;.;.;.;.;.;.;.;.;.;.;.;.;.;.;.;.;.;.;.;.;.;.;.;.;.;.;.;.;.;.;.;.;.
.;.;.;.;.;.;.;B;.;.;.;.;B;.;.;.;.;.;.;.;B;.;.;.;.;B;.;.;.;.;.;.;.;.;.;.;.;.;.;F<<v;B;B;B;B;B;B;B;B;B;B;B;.;.;.;.;B;.;.;.;.;.;.;.;.;.;.;.;.;.;.;.;.;.;.;.;.;.;.;.;.;.;.;.;.;.;.;.;.;.;.;.;.;.;.;.;.;.;.;.;.
.;.;.;.;.;.;.;B;.;.;.;.;B;.;.;.;.;.;.;.;B;.;.;.;.;B;.;.;.;.;.;.;.;.;.;.;.;.;.;.;B;.;.;.;.;.;.;.;.;.;B;.;.;.;.;B;.;.;.;.;.;.;.;.;.;.;.;.;.;.;.;.;.;.;.;.;.;.;.;.;.;.;.;.;.;.;.;.;.;.;.;.;.;.;.;.;.;.;.;.
.;.;.;.;.;.;.;B;.;.;.;.;B;.;.;.;.;.;.;.;B;.;.;.;.;B;.;.;.;.;.;.;.;.;.;.;.;.;.;.;B;.;.;.;.;.;.;.;.;.;B;.;.;.;.;B;.;.;.;.;.;.;.;.;.;.;.;.;.;.;.;.;.;.;.;.;.;.;.;.;.;.;.;.;.;.;.;.;.;.;.;.;.;.;.;.;.;.;.;.
B;B;B;B;B;B;B;B;.;.;.;.;B;B;B;B;.;.;.;.;B;.;.;.;.;B;.;.;.;.;B;B;B;B;B;B;B;B;B;B;B;.;.;.;.;.;.;.;.;.;B;.;.;.;.;B;.;.;.;.;.;.;.;.;.;.;.;.;.;.;.;.;.;.;.;.;.;.;.;.;.;.;.;.;.;.;.;.;.;.;.;.;.;.;.;.;.;.;.;.
B;.;.;.;.;.;F<;.;.;.;.;.;Fvv>;.;.;B;.;.;.;.;B;.;.;.;.;B;.;.;.;.;B;.;.;.;.;.;.;.;.;.;.;.;.;.;.;.;.;.;.;.;B;.;.;.;.;B;.;.;.;.;.;.;.;.;.;.;.;.;.;.;.;.;.;.;.;.;.;.;.;.;.;.;.;.;.;.;.;.;.;.;.;.;.;.;.;.;.;.;.;.
B;.;.;.;.;.;.;.;.;.;.;.;.;.;.;B;.;.;.;.;B;.;.;.;.;B;.;.;.;.;B;.;.;.;.;.;.;.;.;.;.;.;.;.;.;.;.;.;.;.;B;.;.;.;.;B;.;.;.;.;.;.;.;.;.;.;.;.;.;.;.;.;.;.;.;.;.;.;.;.;.;.;.;.;.;.;.;.;.;.;.;.;.;.;.;.;.;.;.;.
B;.;.;.;.;.;.;.;.;.;.;.;.;.;.;B;.;.;.;.;B;.;.;.;.;B;.;.;.;.;B;.;.;.;.;.;.;.;.;.;.;.;.;.;.;.;.;.;.;.;B;.;.;.;.;B;.;.;.;.;.;.;.;.;.;.;.;.;.;.;.;.;.;.;.;.;.;.;.;.;.;.;.;.;.;.;.;.;.;.;.;.;.;.;.;.;.;.;.;.
B;.;.;.;.;.;.;.;.;.;.;.;.;.;.;B;.;.;.;.;B;.;.;.;.;B;.;.;.;.;B;.;.;.;.;.;.;.;.;.;.;.;.;.;.;.;.;.;.;.;B;.;.;.;.;B;.;.;.;.;.;.;.;.;.;.;.;.;.;.;.;.;.;.;.;.;.;.;.;.;.;.;.;.;.;.;.;.;.;.;.;.;.;.;.;.;.;.;.;.
B;.;.;.;.;B;.;.;.;Fv;B;.;.;.;.;B;.;.;.;.;B;.;.;.;.;B;.;.;.;.;B;.;.;.;.;.;.;.;.;.;.;.;.;.;.;.;.;.;.;.;B;;;;.;B;.;.;.;.;.;.;.;.;.;.;.;.;.;.;.;.;.;.;.;.;.;.;.;.;.;.;.;.;.;.;.;.;.;.;.;.;.;.;.;.;.;.;.;.
B;.;.;.;.;B;.;.;.;.;B;.;.;.;.;B;.;.;.;.;B;.;.;.;.;B;.;.;.;.;B;.;.;.;.;.;.;.;.;.;.;.;.;.;.;.;.;.;.;.;B;.;.;.;.;B;.;.;.;.;.;.;.;.;.;.;.;.;.;.;.;.;.;.;.;.;.;.;.;.;.;.;.;.;.;.;.;.;.;.;.;.;.;.;.;.;.;.;.;.
B;.;.;.;.;B;.;.;.;.;B;.;.;.;.;B;.;.;.;.;B;.;.;.;.;B;.;.;.;.;B;.;.;.;.;.;.;.;.;.;.;.;.;.;.;.;.;.;.;.;B;.;.;.;.;B;.;.;.;.;.;.;.;.;.;.;.;.;.;.;.;.;.;.;.;.;.;.;.;.;.;.;.;.;.;.;.;.;.;.;.;.;.;.;.;.;.;.;.;.
B;.;.;.;.;B;.;.;.;.;B;.;.;.;.;B;.;.;.;.;B;.;.;.;.;B;.;.;.;.;B;.;.;.;.;.;.;.;.;.;.;.;.;.;.;.;.;.;.;.;B;.;.;.;.;B;.;.;.;.;.;.;.;.;.;.;.;.;.;.;.;.;.;.;.;.;.;.;.;.;.;.;.;.;.;.;.;.;.;.;.;.;.;.;.;.;.;.;.;.
B;.;.;.;.;B;.;.;.;.;B;.;.;.;.;B;.;.;.;.;B;.;.;.;.;B;.;.;.;.;B;.;.;.;.;.;.;.;.;.;.;.;.;.;.;.;.;.;.;.;B;.;.;.;.;B;.;.;.;.;.;.;.;.;.;.;.;.;.;.;.;.;.;.;.;.;.;.;.;.;.;.;.;.;.;.;.;.;.;.;.;.;.;.;.;.;.;.;.;.
B;.;.;.;.;B;.;.;.;.;B;.;.;.;.;B;.;.;.;.;B;.;.;.;.;B;.;.;.;.;B;.;.;.;.;.;.;.;.;.;.;.;.;.;.;.;.;.;.;.;B;.;.;.;.;B;.;.;.;.;.;.;.;.;.;.;.;.;.;.;.;.;.;.;.;.;.;.;.;.;.;.;.;.;.;.;.;.;.;.;.;.;.;.;.;.;.;.;.;.
B;.;.;.;.;B;.;.;.;.;B;.;.;.;.;B;.;.;.;.;B;.;.;.;.;.;.;.;.;.;B;.;.;.;.;.;.;.;.;.;.;.;.;.;.;.;.;.;.;.;B;;;;.;B;.;.;.;.;.;.;.;.;.;.;.;.;.;.;.;.;.;.;.;.;.;.;.;.;.;.;.;.;.;.;.;.;.;.;.;.;.;.;.;.;.;.;.;.
B;.;.;.;.;B;.;.;.;.;B;.;.;.;.;B;.;.;.;.;B;.;.;.;.;.;.;.;.;.;B;.;.;.;.;.;.;.;.;.;.;.;.;.;.;.;.;.;.;.;B;.;.;.;.;B;.;.;.;.;.;.;.;.;.;.;.;.;.;.;.;.;.;.;.;.;.;.;.;.;.;.;.;.;.;.;.;.;.;.;.;.;.;.;.;.;.;.;.;.
B;.;.;.;.;B;.;.;.;.;B;.;.;.;.;B;.;.;.;.;B;.;.;.;.;.;.;.;.;.;B;.;.;.;.;.;.;.;.;.;.;.;.;.;.;.;.;.;.;.;B;.;.;.;.;B;.;.;.;.;.;.;.;.;.;.;.;.;.;.;.;.;.;.;.;.;.;.;.;.;.;.;.;.;.;.;.;.;.;.;.;.;.;.;.;.;.;.;.;.
B;.;.;.;.;B;.;.;.;.;B;.;.;.;.;B;.;.;.;.;B;.;.;.;.;.;.;.;.;.;B;.;.;.;.;.;.;.;.;.;.;.;.;.;.;.;.;.;.;.;B;.;.;.;.;B;.;.;.;.;.;.;.;.;.;.;.;.;.;.;.;.;.;.;.;.;.;.;.;.;.;.;.;.;.;.;.;.;.;.;.;.;.;.;.;.;.;.;.;.
B;.;.;.;.;B;.;.;.;.;B;.;.;.;.;B;.;.;.;.;B;B;B;B;B;B;B;B;B;B;B;.;.;.;.;.;.;.;.;.;.;.;.;.;.;.;.;.;.;.;B;.;.;.;.;B;.;.;.;.;.;.;.;.;.;.;.;.;.;.;.;.;.;.;.;.;.;.;.;.;.;.;.;.;.;.;.;.;.;.;.;.;.;.;.;.;.;.;.;.
B;.;.;.;.;B;.;.;.;.;B;.;.;.;.;B;.;.;.;.;.;.;.;.;.;.;.;.;.;.;.;.;.;.;.;.;.;.;.;.;.;.;.;.;.;.;.;.;.;.;B;.;.;.;.;B;.;.;.;.;.;.;.;.;.;.;.;.;.;.;.;.;.;.;.;.;.;.;.;.;.;.;.;.;.;.;.;.;.;.;.;.;.;.;.;.;.;.;.;.
B;.;.;.;.;B;.;.;.;.;B;.;.;.;.;B;.;.;.;.;.;.;.;.;.;.;.;.;.;.;.;.;.;.;.;.;.;.;.;.;.;.;.;.;.;.;.;.;.;.;B;.;.;.;.;B;.;.;.;.;.;.;.;.;.;.;.;.;.;.;.;.;.;.;.;.;.;.;.;.;.;.;.;.;.;.;.;.;.;.;.;.;.;.;.;.;.;.;.;.
B;.;.;.;.;B;.;.;.;.;B;.;.;.;.;B;.;.;.;.;.;.;.;.;.;.;.;.;.;.;.;.;.;.;.;.;.;.;.;.;.;.;.;.;.;.;.;.;.;.;B;.;.;Rv0;.;B;.;.;.;.;.;.;.;.;.;.;.;.;.;.;.;.;.;.;.;.;.;.;.;.;.;.;.;.;.;.;.;.;.;.;.;.;.;.;.;.;.;.;.;.
B;.;.;.;.;B;.;.;.;.;B;.;.;.;.;B;.;.;.;.;.;.;.;.;.;.;.;.;.;.;.;.;.;.;.;.;.;.;.;.;.;.;.;.;.;.;.;.;.;.;B;0;0;0;0;B;.;.;.;.;.;.;.;.;.;.;.;.;.;.;.;.;.;.;.;.;.;.;.;.;.;.;.;.;.;.;.;.;.;.;.;.;.;.;.;.;.;.;.;.
B;.;.;.;.;B;.;.;.;.;B;.;.;.;.;B;.;.;.;.;.;.;.;.;.;.;.;.;.;.;.;.;.;.;.;.;.;.;.;.;.;.;.;.;.;.;.;.;.;.;B;.;N^0;.;.;B;.;.;.;.;.;.;.;.;.;.;.;.;.;.;.;.;.;.;.;.;.;.;.;.;.;.;.;.;.;.;.;.;.;.;.;.;.;.;.;.;.;.;.;.
B;.;.;.;.;B;.;.;.;.;B;.;.;.;.;B;.;.;.;.;.;.;.;.;.;.;.;.;.;.;.;.;.;.;.;.;.;.;.;.;.;.;.;.;.;.;.;.;.;.;B;.;.;.;.;B;.;.;.;.;.;.;.;.;.;.;.;.;.;.;.;.;.;.;.;.;.;.;.;.;.;.;.;.;.;.;.;.;.;.;.;.;.;.;.;.;.;.;.;.
B;.;.;.;.;B;.;.;.;.;B;.;.;.;.;B;.;.;.;.;.;.;.;.;.;.;.;.;.;.;.;.;.;.;.;.;.;.;.;.;.;.;.;.;.;.;.;.;.;.;B;.;.;.;.;B;.;.;.;.;.;.;.;.;.;.;.;.;.;.;.;.;.;.;.;.;.;.;.;.;.;.;.;.;.;.;.;.;.;.;.;.;.;.;.;.;.;.;.;.
B;.;.;.;.;B;.;.;.;.;B;.;.;.;.;B;.;.;.;.;.;.;.;.;.;.;.;.;.;.;.;.;.;.;.;.;.;.;.;.;.;.;.;.;.;.;.;.;.;.;B;.;.;.;.;B;.;.;.;.;.;.;.;.;.;.;.;.;.;.;.;.;.;.;.;.;.;.;.;.;.;.;.;.;.;.;.;.;.;.;.;.;.;.;.;.;.;.;.;.
B;.;.;.;.;B;.;.;.;.;B;.;.;.;.;B;.;.;.;.;.;.;.;.;.;.;.;.;.;.;.;.;.;.;.;.;.;.;.;.;.;.;.;.;.;.;.;.;.;.;B;.;.;.;.;B;.;.;.;.;.;.;.;.;.;.;.;.;.;.;.;.;.;.;.;.;.;.;.;.;.;.;.;.;.;.;.;.;.;.;.;.;.;.;.;.;.;.;.;.
B;.;.;.;.;B;.;.;.;.;B;.;.;.;.;B;.;.;.;.;.;.;.;.;.;.;.;.;.;.;.;.;.;.;.;.;.;.;.;.;.;.;.;.;.;.;.;.;.;.;B;.;.;.;.;B;.;.;.;.;.;.;.;.;.;.;.;.;.;.;.;.;.;.;.;.;.;.;.;.;.;.;.;.;.;.;.;.;.;.;.;.;.;.;.;.;.;.;.;.
B;.;.;.;.;B;.;.;.;.;B;.;.;.;.;B;.;.;.;.;.;.;.;.;.;.;.;.;.;.;.;.;.;.;.;.;.;.;.;.;.;.;.;.;.;.;.;.;.;.;B;.;.;.;.;B;.;.;.;.;.;.;.;.;.;.;.;.;.;.;.;.;.;.;.;.;.;.;.;.;.;.;.;.;.;.;.;.;.;.;.;.;.;.;.;.;.;.;.;.
B;.;.;.;.;B;.;.;.;.;B;.;.;.;.;B;.;.;.;.;.;.;.;.;.;.;.;.;.;.;.;.;.;.;.;.;.;.;.;.;.;.;.;.;.;.;.;.;.;.;B;.;.;.;.;B;.;.;.;.;.;.;.;.;.;.;.;.;.;.;.;.;.;.;.;.;.;.;.;.;.;.;.;.;.;.;.;.;.;.;.;.;.;.;.;.;.;.;.;.
B;.;.;.;.;B;.;.;.;.;B;.;.;.;.;B;.;.;.;.;.;.;.;.;.;.;.;.;.;.;.;.;.;.;.;.;.;.;.;.;.;.;.;.;.;.;.;.;.;.;B;.;.;.;.;B;.;.;.;.;.;.;.;.;.;.;.;.;.;.;.;.;.;.;.;.;.;.;.;.;.;.;.;.;.;.;.;.;.;.;.;.;.;.;.;.;.;.;.;.
B;.;.;.;.;C^;.;.;.;.;B;.;.;.;.;B;.;.;.;.;.;.;.;.;.;.;.;.;.;.;.;.;.;.;.;.;.;.;.;.;.;.;.;.;.;.;.;.;.;.;B;.;.;.;.;B;.;.;.;.;.;.;.;.;.;.;.;.;.;.;.;.;.;.;.;.;.;.;.;.;.;.;.;.;.;.;.;.;.;.;.;.;.;.;.;.;.;.;.;.
B;.;.;.;.;.;.;.;.;.;B;.;.;.;.;B;.;.;.;.;.;.;.;.;.;.;.;.;.;.;.;.;.;.;.;.;.;.;.;.;.;B;B;B;B;B;B;B;B;B;B;.;.;.;.;B;.;.;.;.;.;.;.;.;.;.;.;.;.;.;.;.;.;.;.;.;.;.;.;.;.;.;.;.;.;.;.;.;.;.;.;.;.;.;.;.;.;.;.;.
B;.;.;.;.;.;.;.;.;.;B;.;.;.;.;B;.;.;.;.;.;.;.;.;.;.;.;.;.;.;.;.;.;.;.;.;.;.;.;.;.;B;.;.;.;.;.;.;.;.;.;.;.;.;.;B;.;.;.;.;.;.;.;.;.;.;.;.;.;.;.;.;.;.;.;.;.;.;.;.;.;.;.;.;.;.;.;.;.;.;.;.;.;.;.;.;.;.;.;.
B;.;.;.;.;.;.;.;.;.;B;.;.;.;.;B;.;.;.;.;.;.;.;.;.;.;.;.;.;.;.;.;.;.;.;.;.;.;.;.;.;B;.;.;.;.;.;.;.;.;.;.;.;.;.;B;.;.;.;.;.;.;.;.;.;.;.;.;.;.;.;.;.;.;.;.;.;.;.;.;.;.;.;.;.;.;.;.;.;.;.;.;.;.;.;.;.;.;.;.
B;.;.;.;.;.;.;F<;.;.;B;.;.;.;.;B;.;.;.;.;.;.;.;.;.;.;.;.;.;.;.;.;.;.;.;.;.;.;.;.;.;B;.;.;.;.;.;.;.;.;.;.;.;.;.;B;.;.;.;.;.;.;.;.;.;.;.;.;.;.;.;.;.;.;.;.;.;.;.;.;.;.;.;.;.;.;.;.;.;.;.;.;.;.;.;.;.;.;.;.
B;.;.;.;.;B;B;B;B;B;C^;.;.;.;.;B;.;.;.;.;.;.;.;.;.;.;.;.;.;.;.;.;.;.;.;.;.;.;.;.;.;B;.;.;.;.;.;.;.;.;.;.;.;.;.;B;.;.;.;.;.;.;.;.;.;.;.;.;.;.;.;.;.;.;.;.;.;.;.;.;.;.;.;.;.;.;.;.;.;.;.;.;.;.;.;.;.;.;.;.
B;.;.;.;.;.;.;.;.;.;.;.;.;.;.;B;.;.;.;.;.;.;.;.;.;.;.;.;.;.;.;.;.;.;.;.;.;.;.;.;.;B;.;.;.;.;.;.;.;.;.;.;.;.;.;B;.;.;.;.;.;.;.;.;.;.;.;.;.;.;.;.;.;.;.;.;.;.;.;.;.;.;.;.;.;.;.;.;.;.;.;.;.;.;.;.;.;.;.;.
B;.;.;.;.;.;.;.;.;.;.;.;.;.;.;B;.;B;B;B;B;B;B;B;B;B;B;B;B;B;B;B;B;B;B;B;B;B;.;.;.;B;.;.;.;.;B;B;B;B;B;B;B;B;B;B;.;.;.;.;.;.;.;.;.;.;.;.;.;.;.;.;.;.;.;.;.;.;.;.;.;.;.;.;.;.;.;.;.;.;.;.;.;.;.;.;.;.;.;.
B;.;.;.;.;.;.;.;.;.;.;.;.;.;.;B;.;B;.;.;.;.;.;.;.;.;4;.;.;.;.;.;.;.;.;.;.;B;.;.;.;B;.;.;.;.;B;.;.;.;.;.;.;.;.;.;.;.;.;.;.;.;.;.;.;.;.;.;.;.;.;.;.;.;.;.;.;.;.;.;.;.;.;.;.;.;.;.;.;.;.;.;.;.;.;.;.;.;.;.
B;.;.;.;.;.;.;.;.;.;.;.;.;.;.;B;.;B;.;.;.;.;.;.;.;.;4;.;.;.;.;.;.;.;.;.;.;B;.;.;.;B;.;.;.;.;B;.;.;.;.;.;.;.;.;.;.;.;.;.;.;.;.;.;.;.;.;.;.;.;.;.;.;.;.;.;.;.;.;.;.;.;.;.;.;.;.;.;.;.;.;.;.;.;.;.;.;.;.;.
B;.;Fv>;.;.;.;.;.;.;.;.;.;.;Fv<;.;B;.;B;.;.;.;.;.;.;.;.;4;.;.;.;.;.;.;.;.;.;.;B;.;.;.;B;5;5;5;5;B;.;.;.;.;.;.;.;.;.;.;.;.;.;.;.;.;.;.;.;.;.;.;.;.;.;.;.;.;.;.;.;.;.;.;.;.;.;.;.;.;.;.;.;.;.;.;.;.;.;.;.;.;.
B;.;.;.;.;.;.;.;.;.;.;.;.;.;.;B;.;B;.;.;.;.;.;.;.;.;4;.;.;.;.;.;.;.;.;.;.;B;.;.;.;B;.;.;.;.;B;.;.;.;.;.;.;.;.;.;.;.;.;.;.;.;.;.;.;.;.;.;.;.;.;.;.;.;.;.;.;.;.;.;.;.;.;.;.;.;.;.;.;.;.;.;.;.;.;.;.;.;.;.
B;B;B;B;B;B;3;3;3;3;B;B;B;B;B;B;.;B;.;.;.;.;B;B;B;B;B;B;B;B;B;B;B;.;.;.;.;B;.;.;.;B;.;.;.;.;B;.;.;.;.;.;.;.;.;.;.;.;.;.;.;.;.;.;.;.;.;.;.;.;.;.;.;.;.;.;.;.;.;.;.;.;.;.;.;.;.;.;.;.;.;.;.;.;.;.;.;.;.;.
.;.;.;.;.;B;.;.;.;.;B;.;.;.;.;.;.;B;.;.;.;F^;B;.;.;.;.;.;.;.;.;.;B;.;.;.;.;B;.;.;.;B;.;.;.;.;B;.;.;.;.;.;.;.;.;.;.;.;.;.;.;.;.;.;.;.;.;.;.;.;.;.;.;.;.;.;.;.;.;.;.;.;.;.;.;.;.;.;.;.;.;.;.;.;.;.;.;.;.;.
.;.;.;.;.;B;.;.;.;.;B;.;.;.;.;.;.;B;.;.;.;C<;B;.;.;.;.;.;.;.;.;.;B;.;.;.;.;B;.;.;.;B;.;.;.;.;B;.;.;.;.;.;.;.;.;.;.;.;.;.;.;.;.;.;.;.;.;.;.;.;.;.;.;.;.;.;.;.;.;.;.;.;.;.;.;.;.;.;.;.;.;.;.;.;.;.;.;.;.;.
.;.;.;.;.;B;.;.;.;.;B;.;.;.;.;.;.;B;.;.;.;C<;B;.;.;.;.;.;.;.;.;.;B;.;.;.;.;B;.;.;.;B;.;.;.;.;B;.;.;.;.;.;.;.;.;.;.;.;.;.;.;.;.;.;.;.;.;.;.;.;.;.;.;.;.;.;.;.;.;.;.;.;.;.;.;.;.;.;.;.;.;.;.;.;.;.;.;.;.;.
.;.;.;.;.;B;.;.;.;.;B;B;B;B;B;B;B;B;.;.;.;.;B;.;.;.;.;.;.;.;.;.;B;.;.;.;.;B;.;.;.;B;.;.;.;.;B;.;.;.;.;.;.;.;.;.;.;.;.;.;.;.;.;.;.;.;.;.;.;.;.;.;.;.;.;.;.;.;.;.;.;.;.;.;.;.;.;.;.;.;.;.;.;.;.;.;.;.;.;.
.;.;.;.;.;B;.;.;.;.;.;.;.;.;.;.;.;.;.;.;.;Fv;B;B;B;B;B;B;B;B;.;.;B;.;.;.;.;B;.;.;.;B;.;.;.;.;B;.;.;.;.;.;.;.;.;.;.;.;.;.;.;.;.;.;.;.;.;.;.;.;.;.;.;.;.;.;.;.;.;.;.;.;.;.;.;.;.;.;.;.;.;.;.;.;.;.;.;.;.;.
.;.;.;.;.;B;.;.;.;.;.;.;.;.;.;.;.;.;.;.;.;.;.;.;.;.;.;.;.;B;.;.;B;.;.;.;.;B;.;.;.;B;.;.;.;.;B;.;.;.;.;.;.;.;.;.;.;.;.;.;.;.;.;.;.;.;.;.;.;.;.;.;.;.;.;.;.;.;.;.;.;.;.;.;.;.;.;.;.;.;.;.;.;.;.;.;.;.;.;.
.;.;.;.;.;B;.;.;.;.;.;.;.;.;.;.;.;.;.;.;.;.;.;.;.;.;.;.;.;B;.;.;B;.;.;.;.;B;.;.;.;B;.;.;.;.;B;.;.;.;.;.;.;.;.;.;.;.;.;.;.;.;.;.;.;.;.;.;.;.;.;.;.;.;.;.;.;.;.;.;.;.;.;.;.;.;.;.;.;.;.;.;.;.;.;.;.;.;.;.
.;.;.;.;.;B;.;.;.;.;.;.;.;.;.;.;.;.;.;.;.;.;.;.;.;.;.;.;.;B;.;.;B;.;.;.;.;B;.;.;.;B;.;.;.;.;B;.;.;.;.;.;.;.;.;.;.;.;.;.;.;.;.;.;.;.;.;.;.;.;.;.;.;.;.;.;.;.;.;.;.;.;.;.;.;.;.;.;.;.;.;.;.;.;.;.;.;.;.;.
.;.;.;.;.;B;B;B;B;B;B;B;B;B;B;B;B;B;.;.;.;.;.;.;.;.;.;.;.;B;.;.;B;.;.;.;.;B;B;B;B;B;.;.;.;.;B;.;.;.;.;.;.;.;.;.;.;.;.;.;.;.;.;.;.;.;.;.;.;.;.;.;.;.;.;.;.;.;.;.;.;.;.;.;.;.;.;.;.;.;.;.;.;.;.;.;.;.;.;.
.;.;.;.;.;.;.;.;.;.;.;.;.;.;.;.;.;B;.;.;.;.;.;.;.;.;.;.;.;B;.;.;B;.;.;.;.;.;.;.;.;.;.;.;.;.;B;.;.;.;.;.;.;.;.;.;.;.;.;.;.;.;.;.;.;.;.;.;.;.;.;.;.;.;.;.;.;.;.;.;.;.;.;.;.;.;.;.;.;.;.;.;.;.;.;.;.;.;.;.
.;.;.;.;.;.;.;.;.;.;.;.;.;.;.;.;.;B;.;.;.;.;.;.;.;.;.;.;.;B;.;.;B;.;.;.;.;.;.;.;.;.;.;.;.;.;B;.;.;.;.;.;.;.;.;.;.;.;.;.;.;.;.;.;.;.;.;.;.;.;.;.;.;.;.;.;.;.;.;.;.;.;.;.;.;.;.;.;.;.;.;.;.;.;.;.;.;.;.;.
.;.;.;.;.;.;.;.;.;.;.;.;.;.;.;.;.;B;.;.;.;.;.;.;.;.;.;.;.;B;.;.;B;.;.;.;.;.;.;.;.;.;.;.;.;C<;B;.;.;.;.;.;.;.;.;.;.;.;.;.;.;.;.;.;.;.;.;.;.;.;.;.;.;.;.;.;.;.;.;.;.;.;.;.;.;.;.;.;.;.;.;.;.;.;.;.;.;.;.;.
.;.;.;.;.;.;.;.;.;.;.;.;.;.;.;.;.;B;.;.;.;.;.;.;.;.;.;.;.;B;.;.;B;.;.;.;.;.;.;.;.;.;.;.;.;F^;B;.;.;.;.;.;.;.;.;.;.;.;.;.;.;.;.;.;.;.;.;.;.;.;.;.;.;.;.;.;.;.;.;.;.;.;.;.;.;.;.;.;.;.;.;.;.;.;.;.;.;.;.;.
.;.;.;.;.;.;.;.;.;.;.;.;.;.;.;.;.;B;B;B;B;B;B;B;B;.;.;.;.;B;.;.;B;B;B;B;B;B;B;B;B;B;.;.;.;C<;B;.;.;.;.;.;.;.;.;.;.;.;.;.;.;.;.;.;.;.;.;.;.;.;.;.;.;.;.;.;.;.;.;.;.;.;.;.;.;.;.;.;.;.;.;.;.;.;.;.;.;.;.;.
.;.;.;.;.;.;.;.;.;.;.;.;.;.;.;.;.;.;.;.;.;.;.;.;B;.;.;.;.;B;.;.;.;.;.;.;.;.;.;.;.;B;.;.;.;.;B;.;.;.;.;.;.;.;.;.;.;.;.;.;.;.;.;.;.;.;.;.;.;.;.;.;.;.;.;.;.;.;.;.;.;.;.;.;.;.;.;.;.;.;.;.;.;.;.;.;.;.;.;.
.;.;.;.;.;.;.;.;.;.;.;.;.;.;.;.;.;.;.;.;.;.;.;.;B;.;.;.;.;B;.;.;.;.;.;.;.;.;.;.;.;B;.;.;.;.;B;.;.;.;.;.;.;.;.;.;.;.;.;.;.;.;.;.;.;.;.;.;.;.;.;.;.;.;.;.;.;.;.;.;.;.;.;.;.;.;.;.;.;.;.;.;.;.;.;.;.;.;.;.
.;.;.;.;.;.;.;.;.;.;.;.;.;.;.;.;.;.;.;.;.;.;.;.;B;.;.;.;.;B;.;.;.;.;.;.;.;.;.;.;.;B;.;.;.;.;B;.;.;.;.;.;.;.;.;.;.;.;.;.;.;.;.;.;.;.;.;.;.;.;.;.;.;.;.;.;.;.;.;.;.;.;.;.;.;.;.;.;.;.;.;.;.;.;.;.;.;.;.;.
.;.;.;.;.;.;.;.;.;.;.;.;.;.;.;.;.;.;.;.;.;.;.;.;B;4;4;4;4;B;.;.;.;.;.;.;.;.;.;.;.;B;.;.;.;.;B;.;.;.;.;.;.;.;.;.;.;.;.;.;.;.;.;.;.;.;.;.;.;.;.;.;.;.;.;.;.;.;.;.;.;.;.;.;.;.;.;.;.;.;.;.;.;.;.;.;.;.;.;.
.;.;.;.;.;.;.;.;.;.;.;.;.;.;.;.;.;.;.;.;.;.;.;.;B;.;.;.;.;B;.;.;.;.;.;.;.;.;.;.;.;B;.;.;.;.;B;.;.;.;.;.;.;.;.;.;.;.;.;.;.;.;.;.;.;.;.;.;.;.;.;.;.;.;.;.;.;.;.;.;.;.;.;.;.;.;.;.;.;.;.;.;.;.;.;.;.;.;.;.
.;.;.;.;.;.;.;.;.;.;.;.;.;.;.;.;.;.;.;.;.;.;.;.;B;.;.;.;.;B;B;B;B;B;B;B;B;B;B;.;.;B;.;.;.;.;B;.;.;.;.;.;.;.;.;.;.;.;.;.;.;.;.;.;.;.;.;.;.;.;.;.;.;.;.;.;.;.;.;.;.;.;.;.;.;.;.;.;.;.;.;.;.;.;.;.;.;.;.;.
.;.;.;.;.;.;.;.;.;.;.;.;.;.;.;.;.;.;.;.;.;.;.;.;B;.;.;.;.;.;.;.;.;.;.;.;.;.;B;.;.;B;.;.;.;.;B;.;.;.;.;.;.;.;.;.;.;.;.;.;.;.;.;.;.;.;.;.;.;.;.;.;.;.;.;.;.;.;.;.;.;.;.;.;.;.;.;.;.;.;.;.;.;.;.;.;.;.;.;.
.;.;.;.;.;.;.;.;.;.;.;.;.;.;.;.;.;.;.;.;.;.;.;.;B;.;.;.;.;.;.;.;.;.;.;.;.;.;B;.;.;B;.;.;.;.;B;.;.;.;.;.;.;.;.;.;.;.;.;.;.;.;.;.;.;.;.;.;.;.;.;.;.;.;.;.;.;.;.;.;.;.;.;.;.;.;.;.;.;.;.;.;.;.;.;.;.;.;.;.
.;.;.;.;.;.;.;.;.;.;.;.;.;.;.;.;.;.;.;.;.;.;.;.;B;.;.;.;.;.;.;.;.;.;.;.;.;.;B;.;.;B;.;.;.;.;B;.;.;.;.;.;.;.;.;.;.;.;.;.;.;.;.;.;.;.;.;.;.;.;.;.;.;.;.;.;.;.;.;.;.;.;.;.;.;.;.;.;.;.;.;.;.;.;.;.;.;.;.;.
.;.;.;.;.;.;.;.;.;.;.;.;.;.;.;.;.;.;.;.;.;.;.;.;B;.;.;.;.;.;.;.;.;.;.;.;.;.;B;.;.;B;.;.;.;.;B;.;.;.;.;.;.;.;.;.;.;.;.;.;.;.;.;.;.;.;.;.;.;.;.;.;.;.;.;.;.;.;.;.;.;.;.;.;.;.;.;.;.;.;.;.;.;.;.;.;.;.;.;.
.;.;.;.;.;.;.;.;.;.;.;.;.;.;.;.;.;.;.;.;.;.;.;.;B;B;B;B;B;B;B;B;B;B;.;.;.;.;B;.;.;B;.;.;.;.;B;.;.;.;.;.;.;.;.;.;.;.;.;.;.;.;.;.;.;.;.;.;.;.;.;.;.;.;.;.;.;.;.;.;.;.;.;.;.;.;.;.;.;.;.;.;.;.;.;.;.;.;.;.
.;.;.;.;.;.;.;.;.;.;.;.;.;.;.;.;.;.;.;.;.;.;.;.;.;.;.;.;.;.;.;.;.;B;.;.;.;.;B;.;.;B;.;.;.;.;B;.;.;.;.;.;.;.;.;.;.;.;.;.;.;.;.;.;.;.;.;.;.;.;.;.;.;.;.;.;.;.;.;.;.;.;.;.;.;.;.;.;.;.;.;.;.;.;.;.;.;.;.;.
.;.;.;.;.;.;.;.;.;.;.;.;.;.;.;.;.;.;.;.;.;.;.;.;.;.;.;.;.;.;.;.;.;B;.;.;.;.;B;.;.;B;.;.;.;.;B;.;.;.;.;.;.;.;.;.;.;.;.;.;.;.;.;.;.;.;.;.;.;.;.;.;.;.;.;.;.;.;.;.;.;.;.;.;.;.;.;.;.;.;.;.;.;.;.;.;.;.;.;.
.;.;.;.;.;.;.;.;.;.;.;.;.;.;.;.;.;.;.;.;.;.;.;.;.;.;.;.;.;.;.;.;.;B;.;.;.;.;B;.;.;B;.;.;.;.;B;.;.;.;.;.;.;.;.;.;.;.;.;.;.;.;.;.;.;.;.;.;.;.;.;.;.;.;.;.;.;.;.;.;.;.;.;.;.;.;.;.;.;.;.;.;.;.;.;.;.;.;.;.
.;.;.;.;.;.;.;.;.;.;.;.;.;.;.;.;.;.;.;.;.;.;.;.;.;.;.;.;.;.;.;.;.;B;.;.;.;.;B;B;B;B;.;.;.;.;B;.;.;.;.;.;.;.;.;.;.;.;.;.;.;.;.;.;.;.;.;.;.;.;.;.;.;.;.;.;.;.;.;.;.;.;.;.;.;.;.;.;.;.;.;.;.;.;.;.;.;.;.;.
.;.;.;.;.;.;.;.;.;.;.;.;.;.;.;.;.;.;.;.;.;.;.;.;.;.;.;.;.;.;.;.;.;B;.;.;.;.;.;.;.;.;.;.;.;.;B;.;.;.;.;.;.;.;.;.;.;.;.;.;.;.;.;.;.;.;.;.;.;.;.;.;.;.;.;.;.;.;.;.;.;.;.;.;.;.;.;.;.;.;.;.;.;.;.;.;.;.;.;.
.;.;.;.;.;.;.;.;.;.;.;.;.;.;.;.;.;.;.;.;.;.;.;.;.;.;.;.;.;.;.;.;.;B;.;.;.;.;.;.;.;.;.;.;.;.;B;.;.;.;.;.;.;.;.;.;.;.;.;.;.;.;.;.;.;.;.;.;.;.;.;.;.;.;.;.;.;.;.;.;.;.;.;.;.;.;.;.;.;.;.;.;.;.;.;.;.;.;.;.
.;.;.;.;.;.;.;.;.;.;.;.;.;.;.;.;.;.;.;.;.;.;.;.;.;.;.;.;.;.;.;.;.;B;.;.;.;.;.;.;.;.;.;.;.;.;B;.;.;.;.;.;.;.;.;.;.;.;.;.;.;.;.;.;.;.;.;.;.;.;.;.;.;.;.;.;.;.;.;.;.;.;.;.;.;.;.;.;.;.;.;.;.;.;.;.;.;.;.;.
.;.;.;.;.;.;.;.;.;.;.;.;.;.;.;.;.;.;.;.;.;.;.;.;.;.;.;.;.;.;.;.;.;B;.;.;.;.;.;.;.;.;.;.;.;.;B;.;.;.;.;.;.;.;.;.;.;.;.;.;.;.;.;.;.;.;.;.;.;.;.;.;.;.;.;.;.;.;.;.;.;.;.;.;.;.;.;.;.;.;.;.;.;.;.;.;.;.;.;.
.;.;.;.;.;.;.;.;.;.;.;.;.;.;.;.;.;.;.;.;.;.;.;.;.;.;.;.;.;.;.;.;.;B;B;B;B;B;B;B;B;B;B;B;B;B;B;.;.;.;.;.;.;.;.;.;.;.;.;.;.;.;.;.;.;.;.;.;.;.;.;.;.;.;.;.;.;.;.;.;.;.;.;.;.;.;.;.;.;.;.;.;.;.;.;.;.;.;.;.
.;.;.;.;.;.;.;.;.;.;.;.;.;.;.;.;.;.;.;.;.;.;.;.;.;.;.;.;.;.;.;.;.;.;.;.;.;.;.;.;.;.;.;.;.;.;.;.;.;.;.;.;.;.;.;.;.;.;.;.;.;.;.;.;.;.;.;.;.;.;.;.;.;.;.;.;.;.;.;.;.;.;.;.;.;.;.;.;.;.;.;.;.;.;.;.;.;.;.;.
.;.;.;.;.;.;.;.;.;.;.;.;.;.;.;.;.;.;.;.;.;.;.;.;.;.;.;.;.;.;.;.;.;.;.;.;.;.;.;.;.;.;.;.;.;.;.;.;.;.;.;.;.;.;.;.;.;.;.;.;.;.;.;.;.;.;.;.;.;.;.;.;.;.;.;.;.;.;.;.;.;.;.;.;.;.;.;.;.;.;.;.;.;.;.;.;.;.;.;.
.;.;.;.;.;.;.;.;.;.;.;.;.;.;.;.;.;.;.;.;.;.;.;.;.;.;.;.;.;.;.;.;.;.;.;.;.;.;.;.;.;.;.;.;.;.;.;.;.;.;.;.;.;.;.;.;.;.;.;.;.;.;.;.;.;.;.;.;.;.;.;.;.;.;.;.;.;.;.;.;.;.;.;.;.;.;.;.;.;.;.;.;.;.;.;.;.;.;.;.
.;.;.;.;.;.;.;.;.;.;.;.;.;.;.;.;.;.;.;.;.;.;.;.;.;.;.;.;.;.;.;.;.;.;.;.;.;.;.;.;.;.;.;.;.;.;.;.;.;.;.;.;.;.;.;.;.;.;.;.;.;.;.;.;.;.;.;.;.;.;.;.;.;.;.;.;.;.;.;.;.;.;.;.;.;.;.;.;.;.;.;.;.;.;.;.;.;.;.;.
.;.;.;.;.;.;.;.;.;.;.;.;.;.;.;.;.;.;.;.;.;.;.;.;.;.;.;.;.;.;.;.;.;.;.;.;.;.;.;.;.;.;.;.;.;.;.;.;.;.;.;.;.;.;.;.;.;.;.;.;.;.;.;.;.;.;.;.;.;.;.;.;.;.;.;.;.;.;.;.;.;.;.;.;.;.;.;.;.;.;.;.;.;.;.;.;.;.;.;.
